9 55
~~~~~~~~~~~~~~~~~~~~~~~~~~~~~~~~~~~~~~~~~~~~~~~~~~~~~~~
~~BBBBB~~~BBBBB~~BBBBBBB~~~B~~~~~BBB~~~~~BBB~~~~BBBBB~~
~B~~~~~B~B~~~~~B~B~~~~~~~~BB~~~~B~~~B~~~B~~~B~~B~~~~~B~
~B~~~~~~~B~~~~~~~B~~~~~~~B~B~~~B~~~~~B~B~~~~~B~~~~~~~B~
~B~~~~~~~~BBBBB~~BBBBB~~~~~B~~~B~~~~~B~B~~~~~B~~BBBBB~~
~B~~~~~~~~~~~~~B~B~~~~~~~~~B~~~B~~~~~B~B~~~~~B~B~~~~~~~
~B~~~~~B~B~~~~~B~B~~~~~~~~~B~~~~B~~~B~~~B~~~B~~B~~~~~~~
~~BBBBB~~~BBBBB~~BBBBBBB~BBBBB~~~BBB~~~~~BBB~~~BBBBBBB~
~~~~~~~~~~~~~~~~~~~~~~~~~~~~~~~~~~~~~~~~~~~~~~~~~~~~~~~